а=a
б=b
в=v
г=g
д=d
е=e
ё=yo
ж=zh
з=z
и=i
й=j
к=k
л=l
м=m
н=n
о=o
п=p
р=r
с=s
т=t
у=u
ф=f
х=h
ц=c
ч=4
ш=sh
щ=shsh
ъ=''
ы=y
ь='
э=q
ю=yu
я=ya