अ=a
आ=aa
इ=i
ई=ii
उ=u
ऊ=uu
ए=e
ऐ=ai
ओ=o
औ=au
क=k
ख=kh
ग=g
घ=gh
च=ch
छ=chh
ज=j
झ=jh
ट=t
ठ=th
ड=d
ढ=dh
ण=n
त=t
थ=th
द=d
ध=dh
न=n
प=p
फ=ph
ब=b
भ=bh
म=m
य=y
र=r
ल=l
व=v
स=s
श=sh
ष=shh
ह=h